{
  "id": "great-hall",
  "name": "Great Hall",
  "width": 15,
  "height": 10,
  "wcell": 16,
  "terrainTilesheets": [
    "images/ts_rpg.png",
    "images/ts_rpg.png",
    "images/ts_indoor.png"
  ],
  "itemsTilesheet": "images/ts_indoor.png",
  "actorsTilesheet": "images/ts_actors.png",
  "terrainlayers": [[
    "W5 W8 W8 W8 W8 W8 W5 W5 W5 W5 W5 W5 W5 W5 W5",
    "W6 F1 F1 F1 F1 F1 W4 W5 W5 W5 W5 W5 W5 W5 W5",
    "W6 F1 F1 F1 F1 F1 W4 W8 W8 W8 W8 W5 W8 W8 W8",
    "W6 F1 W1 W2 W3 F1 W4 F2 F2 F2 F2 W5 F2 F2 W4",
    "W6 F1 W7 W8 W9 F1 W4 F2 F2 F2 F2 W5 F2 F2 W4",
    "W6 F1 F1 F1 F1 F1 W4 F2 F2 F2 F2 W5 F2 F2 W4",
    "W6 F1 F1 F1 F1 F1 W4 W8 W7 W5 W5 W5 W6 W8 W5",
    "W6 F1 F1 F1 F1 F1 F1 F1 F1 F1 F1 F1 F1 F1 W2",
    "W6 F1 F1 F1 F1 F1 F1 F1 F1 F1 F1 F1 F1 F1 W2",
    "W5 W2 W2 W2 W2 W2 W2 W2 W2 W2 W2 W2 W2 W2 W2"
  ], [
    "-- -- -- -- -- -- -- -- -- -- -- -- -- -- --",
    "-- -- -- -- -- -- -- -- -- -- -- -- -- -- --",
    "-- -- -- -- -- -- -- -- -- -- -- -- -- -- --",
    "-- -- -- -- -- -- -- -- -- -- -- -- -- -- --",
    "-- -- -- -- -- -- -- -- -- -- -- -- -- -- --",
    "-- -- -- -- -- -- -- -- -- -- -- -- -- -- --",
    "-- -- -- -- -- -- -- D1 -- -- -- -- -- D2 --",
    "-- -- -- -- -- -- -- -- -- -- -- -- -- -- --",
    "-- -- -- -- -- -- -- -- -- -- -- -- -- -- --",
    "-- -- -- -- -- -- -- -- -- -- -- -- -- -- --"
  ], [
    "-- -- -- -- -- -- -- -- -- -- -- -- -- -- --",
    "-- -- -- -- -- -- -- -- -- -- -- -- -- -- --",
    "-- -- -- -- -- -- -- -- -- -- -- -- -- -- --",
    "-- -- -- -- -- -- -- -- -- -- -- -- -- -- --",
    "-- -- -- -- -- -- -- C1 T2 C2 -- -- -- -- --",
    "-- -- -- -- -- -- -- -- -- -- -- -- -- -- --",
    "-- -- C3 C3 -- -- -- -- -- -- -- -- -- -- --",
    "-- -- Ta Tb -- -- -- -- -- -- -- -- -- -- --",
    "-- -- C4 C4 -- -- -- -- -- -- -- -- -- -- --",
    "-- -- -- -- -- -- -- -- -- -- -- -- -- -- --"
  ]],
  "zones": [
    "## ## ## ## ## ## ## ## ## ## ## ## ## ## ##",
    "## .. .. .. .. .. ## ## ## ## ## ## ## ## ##",
    "## .. .. .. .. .. ## ## ## ## ## ## ## ## ##",
    "## .. ## ## ## .. ## .. .. .. .. ## .. .. ##",
    "## .. ## ## ## .. ## .. .. .. .. ## .. .. ##",
    "## .. .. .. .. .. ## .. .. .. .. ## .. .. ##",
    "## .. .. .. .. .. ## .. ## ## ## ## ## .. ##",
    "## .. .. .. .. .. .. .. .. .. .. .. .. .. ##",
    "## .. .. .. .. .. .. .. .. .. .. .. .. .. ##",
    "## ## ## ## ## ## ## ## ## ## ## ## ## ## ##"
  ],
  "items":[
    "Table1 Ta 2,2",
    "Table2 Tb 3,2"
  ],
  "actors":[
    "robtwister @1 7,8",
    "lky @2 13,8",
    "npc @3 12,8"
  ]
}

